1011111111
1000001100
1011100001
1001001011
1111111111